 Abdulla, Haval Kawa	Abdulla, Haval Kawa 
 Amundsgård, Synne Karlsen	Amundsgård, Synne Karlsen
 Andreassen, Heidi	Andreassen, Heidi
 Andreassen, Lisa Kristina	Andreassen, Lisa Kristina
 Antonsen, Ingrid	Antonsen, Ingrid
 Apalvik, Miriam Aurora	Apalvik, Miriam Aurora
 Arnes, Mathilde Hallseth	Arnes, Mathilde Hallseth
 Arntsen, Maria Tobiassen	Arntsen, Maria Tobiassen
 Ask, Mathilde Pihl	Ask, Mathilde Pihl
 Augdal, Hanna Bondø	Augdal, Hanna Bondø
 Aune, Ada Wiig	Aune, Ada Wiig
 Aune, Karen Cathrine	Aune, Karen Cathrine
 Austad, Mari	Austad, Mari
 Bakken, Marit	Bakken, Marit
 Bakken, Monika Sødahl	Bakken, Monika Sødahl
 Balstad, Rina Kristine	Balstad, Rina Kristine
 Bekken, Erlend	Bekken, Erlend
 Berg, Gina	Berg, Gina
 Berg, Stine	Berg, Stine
 Bergem, Kari	Bergem, Kari
 Bergsland, Anna Dahl	Bergsland, Anna Dahl
 Berntsen, Maiken Kildal	Berntsen, Maiken Kildal
 Bjerkeseth, Karen Sofie	Bjerkeseth, Karen Sofie
 Bjørnstad, Eline Vitsø	Bjørnstad, Eline Vitsø
 Bjørvik, Anne Langen	Bjørvik, Anne Langen
 Blomlie, Malin	Blomlie, Malin
 Bolanos de Dunn, Faviola Cheryl	Bolanos de Dunn, Faviola Cheryl
 Bolme, Guro	Bolme, Guro
 Borgersen, Silje Kristine	Borgersen, Silje Kristine
 Braseth, Kristin	Braseth, Kristin
 Bredesen, Marianne Opsahl	Bredesen, Marianne Opsahl
 Brenden, Silje	Brenden, Silje
 Bruheim, Lotte Cathrine	Bruheim, Lotte Cathrine
 Bruvik, Malin	Bruvik, Malin
 Buhrkall, Vilde Haugan	Buhrkall, Vilde Haugan
 Børmark, Lisa Jensen	Børmark, Lisa Jensen
 Celik, Eda	Celik, Eda
 Claussen, Frida	Claussen, Frida
 Dekkerhus, Ingrid	Dekkerhus, Ingrid
 Denstad, Kristin Brevik	Denstad, Kristin Brevik
 Ditlefsen, Annika	Ditlefsen, Annika
 Dragåshaug, Kristin	Dragåshaug, Kristin
 Engan, Gunnhild Osmoen	Engan, Gunnhild Osmoen
 Engen, Frida Renathe	Engen, Frida Renathe
 Erazo Medina, Diana Sirley	Erazo Medina, Diana Sirley
 Erlien, Anna Utseth	Erlien, Anna Utseth
 Fischer, Heike	Fischer, Heike
 Fonneløp, Kristine Marie	Fonneløp, Kristine Marie
 Fornes, Helle Krogstad	Fornes, Helle Krogstad
 Forseth, Maren	Forseth, Maren
 Fosshode, Julie Smedås	Fosshode, Julie Smedås
 Fossum, Kjersti Nesdal	Fossum, Kjersti Nesdal
 Fredriksen, Mina Karianne	Fredriksen, Mina Karianne
 Førland, Elise Spæren	Førland, Elise Spæren
 Gallagher, Mari Therese	Gallagher, Mari Therese
 Gardsteig, Malene Hermansen	Gardsteig, Malene Hermansen
 Godø, Anna-Lena	Godø, Anna-Lena
 Gorman, Kerry	Gorman, Kerry
 Granbo, Stine Sjøgren	Granbo, Stine Sjøgren
 Grimstad, Kristin	Grimstad, Kristin
 Grøv, Mailinn	Grøv, Mailinn
 Gulseth, Magnus Erik Gustav	Gulseth, Magnus Erik Gustav
 Gundersen, Anne	Gundersen, Anne
 Guttulsrød, Ingunn	Guttulsrød, Ingunn
 Hafsmo, Trine-Lise	Hafsmo, Trine-Lise
 Hagen, Tonje Larssen	Hagen, Tonje Larssen
 Halvorsen, Aina Kathrine Kühn	Halvorsen, Aina Kathrine Kühn
 Hammervold, Kari Charlotte	Hammervold, Kari Charlotte
 Hansen, Beate Eian	Hansen, Beate Eian
 Hansen, Lene Ruud	Hansen, Lene Ruud
 Hassel, Petter	Hassel, Petter
 Haugland, Anna	Haugland, Anna
 Heggem, Cecilie Flytør	Heggem, Cecilie Flytør
 Heiberg, Eirik	Heiberg, Eirik
 Heidenstrøm, Cecilie Marie Bendiksen	Heidenstrøm, Cecilie Marie Bendiksen
 Hem, Linda	Hem, Linda
 Hesselberg-Meyer, Kamilla	Hesselberg-Meyer, Kamilla
 Hindrum, Karina Aas	Hindrum, Karina Aas
 Hjellen, Klara Anne Nilsen	Hjellen, Klara Anne Nilsen
 Hoel, Ida	Hoel, Ida
 Hojem, Mathilde Flønæs	Hojem, Mathilde Flønæs
 Holsbø, Øystein Jakobsen	Holsbø, Øystein Jakobsen
 Holte, Thor Marius	Holte, Thor Marius
 Hoset, Siv Johanne	Hoset, Siv Johanne
 Hovsbakken, Marthe Alver	Hovsbakken, Marthe Alver
 Hølaas, Ida	Hølaas, Ida
 Håkonsen, Karen Marie	Håkonsen, Karen Marie
 Isefjær, Bente	Isefjær, Bente
 Iversen, Ellen Agnethe Solheim	Iversen, Ellen Agnethe Solheim
 Jakobsen, Sondre	Jakobsen, Sondre
 Jensen, Daniel	Jensen, Daniel
 Jensen, Maiken Lovise Hofstad	Jensen, Maiken Lovise Hofstad
 Johansen, Marte Kristin	Johansen, Marte Kristin
 Johansen, Vilde Gran	Johansen, Vilde Gran
 Johnsen, Hanna	Johnsen, Hanna
 Juul, Vilde	Juul, Vilde
 Jystad, Mari Hatling	Jystad, Mari Hatling
 Kalleberg, Mia Kaels	Kalleberg, Mia Kaels
 Karlsen, Camilla	Karlsen, Camilla
 Karlsen, Signe Holte	Karlsen, Signe Holte
 Kielland, Ane Andersdotter	Kielland, Ane Andersdotter
 Kielland, Julie	Kielland, Julie
 Kjølberg, Karoline	Kjølberg, Karoline
 Klingen, Nina Gåsbakk	Klingen, Nina Gåsbakk
 Kolstad, Hanne Drevland	Kolstad, Hanne Drevland
 Kristiansen, Martine Grande	Kristiansen, Martine Grande
 Kristiansen, Stine Alice	Kristiansen, Stine Alice
 Kristoffersen, Anita	Kristoffersen, Anita
 Kveen, Kaia Vedlog	Kveen, Kaia Vedlog
 Kvilt, Hilde	Kvilt, Hilde
 Kystad, Simon Stenkløv	Kystad, Simon Stenkløv
 Lande, Ingrid	Lande, Ingrid
 Langeng, Kristine Thorsvoll	Langeng, Kristine Thorsvoll
 Langtind, Maria Therese Klæboe	Langtind, Maria Therese Klæboe
 Lehn, Paola Veronica Kiiskinen	Lehn, Paola Veronica Kiiskinen
 Leinum, Stine Elisabeth	Leinum, Stine Elisabeth
 Linga, Karoline	Linga, Karoline
 Liven, Maren Kvarstad	Liven, Maren Kvarstad
 Lorentzen, Hilde Skrøvset	Lorentzen, Hilde Skrøvset
 Lorentzen, Line Solbakken	Lorentzen, Line Solbakken
 Lorentzen, Vegard	Lorentzen, Vegard
 Lothe, Renathe	Lothe, Renathe
 Mangseth, Nora	Mangseth, Nora
 Marsfjell, Ida-Malene Knudsen	Marsfjell, Ida-Malene Knudsen
 Melkvik, Marie	Melkvik, Marie
 Michaelsen, Ane	Michaelsen, Ane
 Michelsen, Stian	Michelsen, Stian
 Midtbø, Kjersti Elisabeth	Midtbø, Kjersti Elisabeth
 Mohamud, Afnaan Ali	Mohamud, Afnaan Ali
 Moland, Hege Venjum	Moland, Hege Venjum
 Monsvold, Caroline Isabel	Monsvold, Caroline Isabel
 Murray, Andre Wilber	Murray, Andre Wilber
 Myrbø, Nadia Løkhaug	Myrbø, Nadia Løkhaug
 Nergård, Cecilie Marie Rekdal	Nergård, Cecilie Marie Rekdal
 Nordvik, Jonette Smebye	Nordvik, Jonette Smebye
 Nyland, Camilla Skau	Nyland, Camilla Skau
 Ofstad, Stine Hoem Ingdal	Ofstad, Stine Hoem Ingdal
 Olsen, Marte Dahl	Olsen, Marte Dahl
 Onsøien, Annikken Elvira Mehren	Onsøien, Annikken Elvira Mehren
 Orvik, Synnøve	Orvik, Synnøve
 Paulsen, Eline	Paulsen, Eline
 Reitan, Rikke Aakerholm	Reitan, Rikke Aakerholm
 Roaldsand, Sara	Roaldsand, Sara
 Rochmann, Andreas Alexander	Rochmann, Andreas Alexander
 Rogn, Åse Berit	Rogn, Åse Berit
 Rognan, Kim Rune Vik	Rognan, Kim Rune Vik
 Romulslie, Veronica	Romulslie, Veronica
 Romundstad, Heidi	Romundstad, Heidi
 Rosenlund, Julia Morenda	Rosenlund, Julia Morenda
 Røskaft, Tina Charlotte Evensen	Røskaft, Tina Charlotte Evensen
 Röstad, Emilie	Röstad, Emilie
 Røstad, Kristin	Røstad, Kristin
 Råheim, Birgitte	Råheim, Birgitte
 Schjetne, Peer Olaf Rygg	Schjetne, Peer Olaf Rygg
 Sefting, Kirsti	Sefting, Kirsti
 Selvik, Johannes Kvamme	Selvik, Johannes Kvamme
 Sigfusdottir, Margret Sylvia	Sigfusdottir, Margret Sylvia
 Sigstadstø, Catrine	Sigstadstø, Catrine
 Sjølie, Ingeborg	Sjølie, Ingeborg
 Skaufel, Ann Kristin Håbrekke	Skaufel, Ann Kristin Håbrekke
 Skei, Margrethe Rodal	Skei, Margrethe Rodal 
 Skogen, Tone	Skogen, Tone
 Skoglund, Jane Terese	Skoglund, Jane Terese
 Skoglund, Mari Middelhuis	Skoglund, Mari Middelhuis
 Skogstad, Jorunn Helene Krog	Skogstad, Jorunn Helene Krog
 Skrødal, Silje	Skrødal, Silje
 Slåen, Lene	Slåen, Len
 Slaatsveen, Ida Emilie	Slaatsveen, Ida Emilie
 Solheim, Emelie Vårli	Solheim, Emelie Vårli
 Solvang, Martine	Solvang, Martine
 Stenseth, Hanna Sætra	Stenseth, Hanna Sætra
 Strand, Tina	Strand, Tina
 Strandbakke, Astrid Hansen	Strandbakke, Astrid Hansen
 Stuberg, Siri Overvik	Stuberg, Siri Overvik
 Støren, Ida Frost	Støren, Ida Frost
 Sunde, Sverre Grønstad	Sunde, Sverre Grønstad
 Svarlien, Marita Sonflå	Svarlien, Marita Sonflå
 Svenkerud, Heidi Pernille Meland	Svenkerud, Heidi Pernille Meland
 Svensson, Frøydis Eline	Svensson, Frøydis Eline
 Søberg, Toril	Søberg, Toril
 Sønstelien, Trine	Sønstelien, Trine
 Sørsdal, Kaja Bast	Sørsdal, Kaja Bast
 Sørvig, Frida	Sørvig, Frida
 Takala, Kristine Vatn	Takala, Kristine Vatn
 Tamnes, Line	Tamnes, Line
 Thorkildsen, Steffen Legran	Thorkildsen, Steffen Legran
 Torve, Eirin	Torve, Eirin
 Trollebø, Elin Øverengen	Trollebø, Elin Øverengen
 Turøy, Cecilie Michelsen	Turøy, Cecilie Michelsen
 Tuven, Anja Edvardsen	Tuven, Anja Edvardsen
 Ulvund, Hanna	Ulvund, Hanna
 Utne, Elin Meiling	Utne, Elin Meiling
 Utne, Martine Ildal	Utne, Martine Ildal
 Vanberg, Ingrid Elisabeth	Vanberg, Ingrid Elisabeth
 Vasseng, Julianne Elise	Vasseng, Julianne Elise
 Vedal, Julie Dyrholm	Vedal, Julie Dyrholm
 Vegheim, Mari	Vegheim, Mari
 Vikhammermo, Maria	Vikhammermo, Maria
 Vikjord, Ellen	Vikjord, Ellen
 von Gegerfelt, Erika Beatrice	von Gegerfelt, Erika Beatrice
 Wahl, Maria Amundsen	Wahl, Maria Amundsen
 Wangen, Marte	Wangen, Marte
 Wollan, Pål Benjamin Wiborg	Wollan, Pål Benjamin Wiborg
 Waage, Sunniva Abirami	Waage, Sunniva Abirami
 Zakrisson, Linda Camilla	Zakrisson, Linda Camilla
 Ødegaardshaugen, Sigrid Hovig	Ødegaardshaugen, Sigrid Hovig
 Aaknes, Renate	Aaknes, Renate
 Aamlid, Ingrid Bjerkholt	Aamlid, Ingrid Bjerkholt
 Aarseth, Anders Salen	Aarseth, Anders Salen
 Aarseth, Synnøve	Aarseth, Synnøve
 Aas, Thale Nøvik	Aas, Thale Nøvik
 Aasen, Camilla Marie	Aasen, Camilla Marie
 Aasen, Elsa Gimse	Aasen, Elsa Gimse
